1.科学心理学的创始人是（    ）。	W•詹姆斯<br>H•艾宾浩斯<br>W•冯特<br>S•弗洛伊德	C	Remark
2.“心理学的任务，在于查明S和R之间的规律性关系”，持这种观点的学派是（    ）。	机能主义心理学<br>构造主义心理学<br>人本主义心理学<br>行为主义心理学	D	Remark
3.持环境决定论观点的是（    ）。	机能主义心理学<br>格式塔心理学<br>行为主义心理学<br>精神分析学说	C	Remark
4.猴子能认识事物的外部联系，说明它们的心理发展到的阶段是（    ）。	知觉<br>思维萌芽<br>思维<br>意识	B	Remark
5.心理活动的器官是动物的（    ）。	感受器<br>神经系统<br>反射弧<br>神经细胞	B	Remark
6.调节睡眠与觉醒的神经结构是（    ）。	小脑<br>脑干网状结构<br>丘脑<br>下丘脑	B	Remark
7.调节内脏系统活动的皮层下中枢位于（    ）。	下丘脑<br>脑干<br>上丘脑<br>小脑	A	Remark
8.躯体感觉中枢位于大脑皮层的（    ）。	额叶<br>颞叶<br>枕叶<br>顶叶	D	Remark
9.听觉中枢位于大脑皮层的（    ）。	额叶<br>颞叶<br>枕叶<br>顶叶	B	Remark
10.脑的最古老部位是（    ）。	小脑<br>间脑<br>大脑<br>脑干	D	Remark
11.在下列感觉中，未经丘脑中转抵达大脑皮质进行信息处理的是（    ）。	视觉<br>听觉<br>嗅觉<br>味觉	C	Remark
12.支配内脏器官的是（    ）。	植物神经系统<br>运动神经系统<br>中间神经系统<br>感觉神经系统	A	Remark
13.感觉适应指在外界刺激持续作用下感受性（    ）。	降低<br>提高<br>不变<br>发生变化	D	Remark
14.音色主要由声音[声波]的决定的。（    ）。	频率<br>波形<br>强度<br>音调	B	Remark
15.白纸在橙色灯照条件下，看起来依然是白色的，这是因为知觉具有（    ）。	选择性<br>恒常性<br>理解性<br>整体性	B	Remark
16.红色让人感到温暖，这是一种（    ）。	感觉适应<br>感觉对比<br>感觉后像<br>联觉	D	Remark
17.人类听觉的适宜刺激的声波是频率（    ）。	200～20000赫兹<br>1000～4000赫兹<br>16～20000赫兹<br>1000～5000赫兹	C	Remark
18.把事物的各个部分、各种属性结合起来加以反映的知觉特性称为知觉的（    ）。	恒常性<br>整体性<br>选择性<br>理解性	B	Remark
19.红灯灭后眼睛里出现了蓝绿色的灯影，这是（    ）。	正后像<br>互补现象<br>负后像<br>彩色对比	C	Remark
20.人脑对物质现象的延续性和顺序性的反映叫（    ）。	运动知觉<br>时间知觉<br>似动知觉<br>方位知觉	B	Remark
21.位于中央窝上的视神经细胞主要是（    ）。	双极细胞<br>边缘细胞<br>杆体细胞<br>锥体细胞	D	Remark
22.人们在知觉外部事物的时候，会把一部分物体当做对象，其他部分当做背景，这表明知觉具有（    ）。	整体性<br>选择性<br>理解性<br>恒常性	B	Remark
23.对弱光敏感的视觉神经细胞是（    ）。	锥体细胞<br>双极细胞<br>杆体细胞<br>水平细胞	C	Remark
24.下列说法中正确的是（    ）。	色觉有缺陷的人一般不能说出物体的颜色<br>色觉有缺陷的人是靠饱和度的差别来辨认颜色的<br>色觉异常绝大多数是遗传原因造成的<br>红绿色盲的人看不见光谱上的黄和蓝	C	Remark
25.语言文字的材料在短时记忆中多是（    ）。	形象的编码<br>抽象的编码<br>视觉的编码<br>听觉的编码	D	Remark
26. 表象可以为想象提供素材，是由于表象具有（    ）。	概括性<br>片断不稳定性<br>可操作性<br>直观形象性	C	Remark
27.遗忘的进程通常是（    ）。	先慢后快<br>先快后慢<br>倒U型曲线<br>U型曲线	B	Remark
28.长时记忆遗忘的主要原因是自然衰退和（    ）。	固化<br>迁移<br>干扰<br>定势	C	Remark
29.信息的编码、储存、提取方式和信息储存时间的长短是划分。（    ）。	记忆过程的标准<br>图象记忆和声象记忆的标准<br>思维过程的标准<br>三个记忆系统的标准	D	Remark
30.瞬时记忆保存的时间一般在（    ）秒。	1<br>2<br>4<br>5	A	Remark
31.先前学习的材料对识记和回忆后学习材料的干扰作用是（    ）。	前摄抑制<br>前干扰<br>倒摄抑制<br>后干扰	A	Remark
32.短时记忆的容量项目一般为（    ）。	5-9个<br>3-7个<br>7-11个<br>9-13个	A	Remark
33.记忆过程有（    ）。	五个基本环节<br>四个基本环节<br>三个基本环节<br>两个基本环节	C	Remark
34.短时记忆中的信息是（    ）。	不能被意识到的<br>一种内隐信息<br>能被意识到的<br>一种主观臆造	C	Remark
35.对语词概括的各种有组织的知识的记忆叫（    ）。	语言记忆<br>意义记忆<br>语义记忆<br>内隐记忆	C	Remark
36.保持曲线来源于（    ）。	冯特<br>艾宾浩斯<br>华生<br>詹姆士	B	Remark
37.根据认知心理学的观点，感觉属信息的（    ）。	输入和登记<br>储存<br>编码和选择<br>提取	A	Remark
38.人们在从事某种活动前的心理准备状态称为（    ）。	迁移<br>定势<br>态度<br>动机	B	Remark
39.人们运用语言交流思想，进行交际的过程叫（    ）。	言语<br>内部言语<br>语言<br>符号系统	A	Remark
40.布洛卡中枢即（    ）。	听觉性言语中枢<br>视觉性言语中枢<br>运动性言语中枢<br>书写性言语中枢	C	Remark
41.大脑左半球额下回靠近外侧裂的部位是（    ）。	言语听觉中枢<br>视觉性言语中枢<br>言语运动中枢<br>书写性言语中枢	C	Remark
42.大脑皮质的颞上回是（    ）。	言语听觉中枢<br>视觉性言语中枢<br>言语运动中枢<br>书写性言语中枢	A	Remark
43.威尔尼克中枢受到严重损伤，患者会出现（    ）。	接受性失语症<br>失读症<br>表达性失语症<br>失写症	A	Remark
44.颞上回受到损伤的人可能出现（    ）。	接受性失语症<br>失读症<br>表达性失语症<br>失写症	A	Remark
45.大脑皮层中角回受到严重损伤，患者会出现（    ）。	失读症<br>表达性失语症<br>失写症<br>接受性失语症	A	Remark
46.位于额中回靠近中央前回的脑区受到严重损伤，可能会导致患者出现（    ）。	失写症<br>接受性失语症<br>失读症<br>表达性失语症	A	Remark
47.想象是（    ）。	对已有的表象进行加工改造，创造出新形象的思维过程<br>认识事物的本质和事物之间的内在联系的过程<br>人脑对客观事物间接的、概括的反映<br>人在觉醒状态下的觉知	A	Remark
48.按照已知的信息和熟悉的规则进行的思维成为（    ）。	发散思维<br>逻辑思维<br>辐合思维<br>抽象思维	C	Remark
49.“会看看门道，不会看看热闹”，说的是知觉具有（    ）。	整体性<br>选择性<br>恒常性<br>理解性	D	Remark
50.看见“月晕”后经常“刮风”，即得出“月晕而风”的结论，这表明思维具有（    ）。	抽象性<br>概括性<br>间接性<br>情境性	C	Remark
51.在觉醒状态下的觉知被称为（    ）。	意识<br>注意<br>认识<br>知觉	A	Remark
52.分心指（    ）。	注意起伏<br>注意转移<br>注意动摇<br>注意分散	D	Remark
53.注意属于（    ）。	认知过程<br>情感过程<br>意志过程<br>心理状态	D	Remark
54.梦出现在（    ）。	快速眼动期<br>深度睡眠阶段<br>睡眠锭阶段<br>△波阶段	A	Remark
55.注意离开了心理活动所要指向的对象，而被无关对象吸引过去的现象，称为（    ）。	注意转移<br>分心<br>注意分配<br>注意集中	B	Remark
56.简单任务下注意的对象范围一般是（    ）。	4～8个<br>4～6个<br>3～7个<br>5～9个	D	Remark
57.根据睡眠中脑电波的变化，可以将睡眠过程分为几个阶段（    ）。	6<br>3<br>5<br>4	D	Remark
58.个体根据任务的要求把注意从一个对象指向并集中到另一个对象上，称为注意（    ）。	分散<br>分配<br>动摇<br>转移	D	Remark
59.按照马斯洛的理论，尊重他人的需要属于（    ）。	生理需要<br>生长性需要<br>社会需要<br>缺失性需要	D	Remark
60.能够引起有机体的定向活动并能满足某种需要的外部条件叫（    ）。	爱好<br>诱因<br>需要<br>内驱力	B	Remark
61.按照马斯洛的理论，实现自我理想的需要属于（    ）。	生理需要<br>生长性需要<br>成就需要<br>自我价值需要	B	Remark
62.由生理需要引起的，推动个体恢复机体内部平衡的唤醒状态称（    ）。	内驱力<br>诱因<br>情绪<br>兴趣	A	Remark
63.动机产生的内在条件是（    ）。	感觉<br>需要<br>气质<br>性格	B	Remark
64.按情绪状态可把情绪分为（    ）。	心境、激情、应激<br>道德感、理智感和美感<br>基本情绪和复合情绪<br>快乐、愤怒、悲哀和恐惧	A	Remark
65.微弱，持久而具有弥漫性特点的情绪体验状态，通常叫（    ）。	应激<br>情感<br>激情<br>心境	D	Remark
66.心理过程包括（    ）。	能力、气质和性格<br>认识、情感和意志<br>知、情、意和能力<br>感知觉、记忆、思维和动机	B	Remark
67.情绪和情感可以传递信息、沟通思想，说明情绪和情感具有（    ）的功能。	适应<br>动机<br>组织<br>信号	D	Remark
68.有爱就有恨，有喜就有悲，有紧张就有轻松，说明情绪和情感具有（    ）的特性。	两极对立<br>不可调和<br>相互关联<br>物极必反	A	Remark
69.从生物进化的角度可以把情绪分为（    ）。	基本情绪和复合情绪<br>生物情绪和社会情绪<br>积极情绪和消极情绪<br>情绪状态和高级情感	A	Remark
70.在出现意外事件或遇到危险情景时出现的高度紧张的情绪状态叫（    ）。	激情<br>心境<br>应激<br>焦虑	C	Remark
71.与易受暗示性和武断性相反的意志品质是（    ）。	坚韧性<br>果断性<br>自制性<br>自觉性	D	Remark
72.“忧者见之而忧，喜者见之而喜”，说明对人有影响的是（    ）。	激情<br>压力<br>应激<br>心境	D	Remark
73.随波逐流，易受暗示的人，其意志品质缺乏（    ）。	自觉性<br>果断性<br>坚韧性<br>自制性	A	Remark
74.视觉性言语中枢受到损伤所产生的失语症叫（    ）。	表达性失语症<br>接受性失语症<br>失读症<br>失写症	C	Remark
75.感受性与感觉阈限之间的关系是（    ）。	常数关系<br>对数关系<br>正比关系<br>反比关系	D	Remark
76.视网膜视细胞层上的视觉神经细胞是（    ）。	感觉细胞和联络细胞<br>锥体细胞和杆体细胞<br>双极细胞和节细胞<br>中央细胞和边缘细胞	B	Remark
77.神经系统是由什么组成的（    ）。	脊髓和脑<br>外周神经系统和中枢神经系统<br>周围神经系统、躯体神经系统和自主神经<br>外周神经系统、脑干、间脑、小脑和端脑	B	Remark
78.在遇到鱼和熊掌不可兼得时所体验到的动机冲突属于（    ）。	双趋式冲突<br>双避式冲突<br>趋避式冲突<br>双重趋避式冲突	A	Remark
79.格式塔心理学主张（    ）。	心理学应该研究心理在适应环境中的机能作用<br>心理学的任务是探讨意识经验由什么元素构成<br>心理学的任务就在于查明刺激与反应之间的规律性关系<br>从整体上来研究心理现象	D	Remark
80.机能主义心理学的主要特点是（    ）。	强调心理学应该研究心理在适应环境中的机能作用<br>认为心理学的任务是探讨意识经验由什么元素构成<br>认为心理学的任务就在于查明刺激与反应之间的规律性关系<br>主张从整体上来研究心理现象	A	Remark
81.生理心理学研究的对象是（    ）。	构成心理的基本元素<br>信息的输入、编码、转换、储存和提取的过程<br>心理活动的生理基础和脑的机制<br>心理在适应环境中的机能作用	C	Remark
82.神经元的是由什么组成的（    ）。	细胞体、细胞核和神经纤维<br>细胞体、树突和轴突<br>细胞、突起和纤维<br>细胞核、突起	B	Remark
83.自主神经由什么组成的（    ）。	躯体神经和植物神经<br>交感神经和副交感神经<br>31对脊神经<br>脊髓和延脑	B	Remark
84.罗杰•斯佩里通过哪项实验证明大脑两半球功能的不对称性（    ）。	割裂脑<br>经典条件反射<br>操作条件反射<br>工具条件反射	A	Remark
85.按照刺激的来源，可把感觉分为（    ）。	视觉和听觉<br>外部感觉和内部感觉<br>运动觉、平衡觉和机体觉<br>视觉、听觉、嗅觉、味觉和肤觉	B	Remark
86.感觉器官对适宜刺激的感觉能力叫（    ）。	绝对感觉阈限<br>感受性<br>感觉阈限<br>最小可觉差	B	Remark
87.1860年法国医生布洛卡发现了（    ）。	运动性言语中枢<br>听觉性言语中枢<br>视觉性言语中枢<br>书写性言语中枢	A	Remark
88.听觉的感受器是（    ）。	潜艇器官<br>听神经<br>科蒂氏器官<br>三个半规管和耳石	C	Remark
89.一个声音由于同时起作用的其他声音的干扰使听觉阈限升高的现象叫（    ）。	听觉适应<br>声音掩蔽<br>听觉对比<br>听觉疲劳	B	Remark
90.生理零度是指（    ）。	皮肤表面的温度<br>37℃<br>36.5℃<br>正常的体温	A	Remark
91.内脏器官的活动处于正常状态时（    ）。	引不起内脏感觉<br>引起不太强的内脏感觉<br>引起节律性的内脏感觉<br>引起忽强忽弱的内脏感觉	A	Remark
92.外界刺激停止作用后暂时保留一段时间的感觉形象叫（    ）。	对光适应<br>感觉后像<br>对暗适应<br>感觉对比	B	Remark
93.联觉是指（    ）。	在外界刺激持续作用下感受性发生变化的现象<br>外界刺激停止作用后，暂时保留的感觉印象<br>不同刺激作用于同一感觉器官使感受性发生变化的现象<br>一个刺激不仅引起一种感觉，同时还引起另一种感觉的现象	D	Remark
94.生物节律给人提供了判断时间的信息，所以，这种节律也可叫（    ）。	生活节律<br>作息规律<br>生物钟<br>生物反馈	C	Remark
95.记忆是（    ）。	过去的经验在头脑中的反映<br>对客观事物直接的反映<br>对客观事物间接的反映<br>对客观事物概括的反映	A	Remark
96.一幅图画，把白色当作知觉的对象看起来是个花瓶，把黑色当作知觉的对象看起来是两个对着的人脸，这说明知觉具有（    ）。	整体性<br>选择性<br>恒常性<br>理解性	B	Remark
97.和一个人的愿望相联系并指向未来的想象叫（    ）。	幻想<br>无意想象<br>梦<br>有意想象	A	Remark
98.心理活动或意识活动对一定对象的指向和集中是（    ）。	认识<br>注意<br>意志<br>想象	B	Remark
99.在同一时间内把注意指向不同对象，同时从事几种不同的活动，这是（    ）。	注意的转移<br>注意的分散<br>注意的分配<br>注意的动摇	C	Remark
100.情绪变化的外部表现模式叫（    ）。	激情<br>表征<br>应激<br>表情	D	Remark

1.下列说法中正确的是 【多选题】（    ）。	认知是人认识外界事物的过程<br>意志是需要克服困难和挫折的行为<br>人格可以通过心理过程得到表现<br>情感属于心理过程	A<br>C<br>D	Remark
2.心理过程包括 【多选题】（    ）。	意志过程<br>认知过程<br>行为过程<br>情感过程	A<br>B<br>D	Remark
3.神经元具有下面哪项功能 【多选题】（    ）。	接受刺激<br>传递信息	A<br>B	Remark
4.脑干包括 【多选题】（    ）。	丘脑<br>延脑<br>脑桥<br>中脑	B<br>C<br>D	Remark
5.下列说法中正确的是 【多选题】（    ）。	人耳对1000～4000赫兹的声波最敏感<br>人耳对16～20000赫兹的声波最敏感<br>老年人首先丧失的是对高频声波的听觉<br>老年人首先丧失的是对低频声波的听觉	A<br>C	Remark
6.关于色盲，正确的说法是 【多选题】（    ）。	色盲大多数是遗传的原因造成的<br>女性色盲比男性色盲多<br>色盲患者一般也能“辨认”颜色<br>男性色盲比女性色盲多	A<br>C<br>D	Remark
7.关于时间知觉，正确的说法是 【多选题】（    ）。	视觉比触觉估计时间的准确度高<br>听觉比触觉估计时间准确度高<br>生物钟是人们估计时间的重要依据<br>个体的情绪状态会影响时间知觉	B<br>C<br>D	Remark
8.错觉的性质包括 【多选题】（    ）。	是对客观事物的歪曲知觉<br>错觉所产生的歪曲带有固定的倾向<br>只要知道错觉产生的原因，错觉是可以克服的<br>只要具备产生错觉的条件，错觉就一定会发生	A<br>B<br>D	Remark
9.绿叶陪衬下的红花看起来更红了，这是 【多选题】（    ）。	同时对比现象<br>相继对比现象<br>彩色对比现象<br>感觉适应现象	A<br>C	Remark
10.下列说法中不科学的是 【多选题】（    ）。	痛觉反映一个人意志力强弱<br>痛觉对机体具有保护作用<br>痛觉反映了一个人的灵敏程度<br>痛觉比较容易适应	A<br>C<br>D	Remark
11.由于不同的感觉器官之间的相互作用而形成的错觉包括（    ）。	线条长短的错觉<br>视听错觉<br>面积大小的错觉<br>形重错觉	B<br>D	Remark
12.人估计时间的依据包括 【多选题】（    ）。	心理活动的周期性变化<br>各种计时工具<br>生理活动的周期性变化<br>各种客观规律	A<br>B<br>C	Remark
13.声波的特性包括 【多选题】（    ）。	响度<br>音色<br>波形<br>频率	C<br>D	Remark
14.彩色的特性包括 【多选题】（    ）。	饱和度<br>明度<br>照度<br>色调	A<br>B<br>D	Remark
15.声音的性质包括 【多选题】（    ）。	饱和度<br>音调<br>音色<br>频率	B<br>C	Remark
16.听觉具有音调、响度和音色三种特性，这些主要受声波的振幅、波形和频率等物理学特性影响。下列匹配中错误的包括 【多选题】（    ）。	响度-振幅<br>音色-波形<br>音色-频率<br>响度-频率	C<br>D	Remark
17.关于痛觉，正确的说法包括 【多选题】（    ）。	最难适应的感觉<br>只属于外部感觉<br>只属于内部感觉<br>具有机体保护的作用	A<br>D	Remark
18.遗忘是指 【多选题】（    ）。	从大脑中提取知识经验的过程<br>对识记过的材料不能回忆的现象<br>对识记过的材料不能再认的现象<br>过去的经验在头脑中的反映	B<br>C	Remark
19.长时记忆遗忘的主要原因包括 【多选题】（    ）。	自然衰退<br>编码错误<br>前摄抑制<br>倒摄抑制	A<br>C<br>D	Remark
20.瞬时记忆的编码方式包括 【多选题】（    ）。	语义<br>感觉后象<br>语音<br>刺激物的形象	B<br>D	Remark
21.记忆是 【多选题】（    ）。	改变信息和知识经验的存储方式的过程<br>人脑对输入的信息进行编码、储存和提取的过程<br>过去的经验在头脑中的反映<br>人脑对客观事物间接的、概括的反映	B<br>C	Remark
22.表象的作用包括 【多选题】（    ）。	积累理性知识<br>从感知向思维过渡的桥梁<br>为想象提供素材<br>创造新形象	B<br>C	Remark
23.遗忘的主要原因包括 【多选题】（    ）。	信息错构<br>信息干扰<br>自然衰退<br>意识抑制	B<br>C	Remark
24.思维最主要的特征包括 【多选题】（    ）。	间接性<br>可操作性<br>概括性<br>抽象性	A<br>C	Remark
25.根据思维的形态所划分的思维的种类包括 【多选题】（    ）。	动作思维<br>形象思维<br>抽象思维<br>创造性思维	A<br>B<br>C	Remark
26.关于概念，正确的说法包括 【多选题】（    ）。	是以词来标示和记载的<br>是思维活动借以进行的单元<br>是人脑对客观事物本质属性的反映<br>是对客观事物的整体反映	A<br>B<br>C	Remark
27.关于概念，正确的说法包括 【多选题】（    ）。	个体掌握概念的层次反映其思维发展水平<br>人工概念是人为制造的概念<br>概念的内涵越深，外延越窄<br>概念的内涵越浅，外延越窄	A<br>B<br>C	Remark
28.影响问题解决的主要原因包括 【多选题】（    ）。	迁移作用<br>原型启发作用<br>定势作用<br>动机作用	A<br>B<br>C	Remark
29.下列说法中正确的包括 【多选题】（    ）。	语言是一种社会现象<br>言语是一种心理现象<br>言语是人们进行交流的工具<br>言语要借助语言来实现	A<br>B<br>D	Remark
30.言语的特点包括 【多选题】（    ）。	言语是人们运用语言交流思想、进行交际的过程<br>言语是一种心理现象<br>言语活动离不开语言<br>言语是一种社会现象	A<br>B<br>C	Remark
32.关于定势的描述，正确的包括 【多选题】（    ）。	是一种心理准备状态<br>有时会促进问题解决<br>有时会干扰问题解决<br>是己有的知识和经验	A<br>B<br>C	Remark
33.关于意识，正确的说法包括 【多选题】（    ）。	是人和动物心理的根本区别<br>是自然进化的最高产物<br>是物质发展最高阶段的产物<br>是在觉醒状态下的觉知	A<br>B<br>C<br>D	Remark
34.注意分配的条件是同时进行的几种活动 【多选题】（    ）。	必须其中有非常熟练的<br>必须都是非常熟练的<br>不能有内在的联系<br>必须有内在的联系	A<br>D	Remark
35.容易引起无意注意的刺激包括 【多选题】（    ）。	强度大的刺激<br>突然出现的刺激<br>固定不变的物体<br>新颖的刺激	A<br>B<br>D	Remark
36.注意的特点包括 【多选题】（    ）。	指向性<br>目的性<br>集中性<br>持久性	A<br>C	Remark
37.下列说法正确的包括 【多选题】（    ）。	动机是在需要的基础上产生的<br>动机和效果一定是一致的<br>动机是人活动的内部动力<br>不同的活动可以由相同的动机引起	A<br>C<br>D	Remark
38.按照马斯洛的理论，免于恐惧的需要属于 【多选题】（    ）。	生理需要<br>生长性需要<br>安全需要量<br>缺失性需要	C<br>D	Remark
39.性的需要属于 【多选题】（    ）。	自然需要<br>生物需要<br>社会需要<br>获得性需要	A<br>B	Remark
40.符合马斯洛需要层次理论的说法包括 【多选题】（    ）。	层次越高的需要出现越晚<br>层次越低的需要出现越晚<br>层次越低的需要力量越强<br>层次越高的需要力量越强	A<br>C	Remark
41.以下正确的说法包括 【多选题】（    ）。	人和动物的自然需要是一样的<br>自然需要是由生理的不平衡引起的<br>交往的需要属于获得性需要<br>物质需要和精神需要之间有密切的关系	B<br>C<br>D	Remark
42.兴趣的品质包括 【多选题】（    ）。	倾向性<br>广阔性<br>持久性<br>效能	A<br>B<br>C<br>D	Remark
43.需要 【多选题】（    ）。	是有机体内部不平衡状态<br>是人对客观外界事物的态度的体验<br>表现为有机体对内外环境条件的欲求<br>是激发并维持个体活动的内部动力	A<br>C	Remark
44.影响动机产生的因素包括 【多选题】（    ）。	内驱力<br>诱因<br>内归因<br>情绪	A<br>B<br>D	Remark
45.意志的品质有 【多选题】（    ）。	自觉性<br>目的性<br>坚韧性<br>自制性	A<br>C<br>D	Remark
46.下面活动属于意志行动的包括 【多选题】（    ）。	散步吹口哨<br>背诵古文<br>摇头晃脑<br>小学生登山	B<br>D	Remark
47.心境的特点包括 【多选题】（    ）。	微弱性<br>持久性<br>弥散性<br>破坏性	A<br>B<br>C	Remark
48.大脑的外层叫 【多选题】（    ）。	大脑灰质<br>大脑白质<br>大脑皮质<br>大脑皮层	A<br>C<br>D	Remark
49.下列选项中属于无条件反射的是 【多选题】（    ）。	吃东西流口水<br>强光照射下瞳孔收缩<br>看见酸梅就流口水<br>一朝被蛇咬，十年怕井绳	A<br>B	Remark
50.感觉阈限是一个范围 【多选题】（    ）。	能够感觉到的最小刺激强度叫下限<br>能够引起中等强度感觉的刺激强度叫适宜刺激<br>能够忍受的刺激的最大强度叫上限<br>下限和上限之间的刺激都是可以引起感觉的范围	A<br>C<br>D	Remark



